# --goals 9_7 5_9 8_10 (first 2 for `individual`, all 3 for `team`)
# MAX_NUM_STEP 90 (for `individual`) 120 (for `team`)
@@@@@@@@@@@@@@@@@@
@....@@@@......@@@
@...............@@
@......@@@.......@
@......@.....@...@
@............@...@
@....@@@@@.......@
@................@
@......@@@.......@
@........@.......@
@...@........@...@
@...@@...........@
@..........@.....@
@@@@.......@@....@
@.....@....@....@@
@.....@..........@
@............@...@
@@@@@@@@@@@@@@@@@@